Class -> PrimitiveClass
	|DefinedClass
	|Error
ClassHeader-> CLASS_COLON CLASS_IDENTIFIERS BROKEN_LINE

DisjointAndIndividuals-> DisjointClasses Individuals

DisjointClasses-> DisjointClassesHead DisjointClassesBody BROKEN_LINE
		| e
DisjointClassesHead-> DISJOINT_CLASSES_COLON BROKEN_LINE
DisjointClassesBody-> CLASS_IDENTIFIERS DisjointClassesBodyComma
DisjointClassesBodyComma-> COMMA CLASS _IDENTIFERS DisjointClassesBodyComma
			  |e
Individuals-> IndividualsHead IndividualsBody
	    | e
IndividualsHead-> INDIVIDUALS_COLON BROKEN_LINE
IndividualsBody-> INDIVIDUAL_NAME IndividualNameComma
IndividualNameComma-> COMMA BROKEN_LINE INDIVIDUAL_NAME IndividualNameComma
		    | e
ClassEnd-> BROKEN_LINE
	  |EOF
	  |e
PrimitiveClass-> ClassHeader PrimitiveClassBody DisjointAndIndividuals ClassEnd
PrimitiveClassBody-> SubClassOfHead SubClassOfBody
SubClassOfHead-> SUBCLASS_COLON BROKEN_LINE
SubClassOfBody-> SubClassOfBodyIten COMMA BROKEN_LINE SubClassOfBody
		|SubClassOfBodyIten
SubClassOfBodyIten-> PropertyIdentifier Connector SubClassOfBodyItenPair
					| CLASS_IDENTIFIERS

PropertyIdentifier-> PROPERTY_IDENTIFIERS_HAS
					| PROPERTY_IDENTIFIERS_IS
					| CLASS_IDENTIFIERS

Connector-> SOME

SubClassOfBodyItenPair->  CLASS_IDENTIFIERS
						| DATA_TYPE

DefinedClass-> ClassHeader DefinedClassBody DisjointAndIndividuals ClassEnd



